1111111111111111111111111111111111111111111111111111111111111111111111111111111111111111111
10000000C0010000000000000000C00000000000111000000000000000000000000000111C00000000000000001
1000000011111111111100000000000000001000111000000000000000000000C00000111000000000001100001
1000000010001000000000000000000000001000001000000000000000110000000000C00000000100000000001
1000000000000000000000000000000000000000000000000000000000000000000000000000000000000000001
1000000000000000000000010000000000000000000100000000000000001000000000000000000000000000001
1000000P00000000000000000000000000000000000000000000000000000000000000000000000000000000001
1000000000000000000000000000000000000000000000000000000000000000000000000000000000000000001
1000000001000001000000000000000000000000010000000000000011100000000000000000100000000000001
1000000000000001000000000000010000000000010000000000000000100100000000000000100000000000001
1000000000011111000000000C11110000000000011110000000000000100100000000000000100000000000001
1000000000010000000000001110000000000000000010000000000000111100000000000011100000000000001
100000000001000000000000000000C000000000000010000000000000000000000010000110000000000000001
1000000000011100000001111110000000000000000010000000000000000000000010000100000000000010001
1000111000000000000001100000000000000001111000000000001100000000000010000100000000000010001
1000001000000010000000000000000011000000000000000001111100000000000010000111111100000010001
1000000000001110000000000C00000011000000000000000000000100000000000011100000000100000010001
1000C00000000000000000000000000000000000000000C00000000110000000000000100000000100000010001
1000000000000000000000000000000000000000000000000000000010000000001100100000000100000010001
1000000000000000000000000000000000000000000000000000000011100000000111100000000100000010001
1000000000000000111000000000000000000000000000000000000000000000000000000000000100000111001
100000000000000000100000000001010000000000100000000000000C000000000000000000000100000001001
100011100000000000100000000001E100000000001000000000000000000000000000000000111100000001101
1000101000000000001111000000000000000000001111000000000000000000000010000000000000000001111
1000111000000000C00001000000000000000000001001000000000000000000000010000000000000000000001
1000000000000000000001111100000000100000000001000000000111111000000010000000011111111111111
1000000000000000000000000000000000100000111111000000000100000000000010000000000000000000001
1000111111000000000000000000000000100000100001000000000100000000000010000000000000000000001
1000000001000000000000000000000000111111100001000C0111110000C000001110000000000100000000001
1000000001000000000000000000000000000000000001000000000000000000000000000000000111000000001
1000000001C00000000000000000000000000000000001000000000000000000000000000000000001000000001
1111111111111111111111111111111111111111111111111111111111111111111111111111111111111111111
