1111111111111
100010P001001
10C0E00110001
1000000001101
1000000011E01
1111111111111
