111111111
100001P01
110000011
10100E101
111111111
