11111111111111111111
100001C1000000000011
1000011100P000010001
10C00111100000110C01
1000000000E000001001
11111111111111111111
