111111111
1P00q0001
100E00C01
100001001
111111111
