111111111
10010P001
10C1001P1
10001E101
111111111
