11111111111111111111
100000C0000000000011
1000011100P000010001
10C00111111100110C01
1000000001E100001001
11111111111111111111
