1111111111111
1001100001001
1000010100000
1011001000111
1111111111111
